###################################B#
# #       #             #         # #
# # ##### # ### ##### ### ### ### # #
#       #   # #     #     # # #   # #
##### # ##### ##### ### # # # ##### #
#   # #       #     # # # # #     # #
# # ####### # # ##### ### # ##### # #
# #       # # #   #     #     #   # #
# ####### # # ### # ### ##### # ### #
#     #   # #   # #   #     # #     #
# ### ### # ### # ##### #   # #######
#   #   # # #   #   #   # # #   #   #
####### # # # ##### # ### # ### ### #
#     # #   # #     #   # #   #     #
# ### # ##### ### # ### ### ####### #
# #   #     #     #   # # #       # #
# # ##### # ### ##### # # ####### # #
# #     # # # # #     #       # #   #
# ##### # # # ### ##### ##### # #####
# #   # # #     #     # #   #       #
# # ### ### ### ##### ### # ##### # #
# #         #     #       #       # #
#A###################################